111111111111111111111111111111111
100100000P0C000000P0000000C000001
1000011111001010000011100100E0011
10P111E00000101101000110000011011
100000000000000111110000000111001
100001100P01000001000110C00010001
10000000E0000001111100000P0111001
100001100001000001000110000010001
100000000000000111110000000111001
100001100001000001000110000010001
100000000000000111110000000111001
100001100001000001000110P00010001
100100000P0C0000000E0000000C00001
100001111100101000001110010000011
10P111E0000P101101000110000011011
100P00000000000111110000000111001
100001100001000001000110000010001
10000P00000P00011111000P000111001
10000110000100C00100011000E010001
10000000E000000111110000000111001
111111111111111111111111111111111