111111111111111111111111111111111111111111
111110000011110011111100000001011111011111
100100000000000111111100000001011111011111
110000000E11110001111100000001011111011111
111110000011000000000000000001011111011111
111110000011100011111100000001011111011111
1111100000111111111111000000P0000000000001
111111101111111111111100000001011111011111
100000001011111011111100000001011111011111
111110000011110P00000000000001011111011111
100100C00000000111111100000001011111011111
110000000E11110001111100000001011111011111
111110000011000000011100000001011111011111
111110000011100011111100000001011111011111
111111111111111111111111111111111111111111